#####################################
#...................................#
#..............s....................#
#........#.........r.....#..........#
#...........r......................##
#.......#.....#....................@d
#..........#...r.......#...........##
#...................................#
#...........s............#..........#
#...................................#
#...................................#
#####################################
