#############################################
#.......#..g....#############################
a.@.............d###########................#
#................{.........{................#
#.......#..g....############................#
#############################################
