################
(.@..hhhh......#
#..............#
#..............#
#..............#
#..............#
#...h.h.I.wk...#
################
