#################################
#......#########.....r.r........############################
a.@.r..#########.........r......X...........X...............#
#####-##########.......r........#############.......R.......d
#####.##########........r.......#############...............#
#####..r..................s.....#############...............#
#############################################################
