#############################
a...........X.............R.#############
##############..........................#
###############.....S.......##########..#
               #############000000000#..#
0000000000000000000000000000000000000####
