################
(.@............#
#..............#
#..............#
#..............#
#..............#
#...h.h.I.wk...#
################
