#############################################
#.......#..g....#############################
a.@.............d###########................#
#...........................................#
#.......#..g....############................#
#############################################
