#################################################
#.....###.......................................#
#.....###.T......###..........................###
a......@.........0##..........................d##
#................###..........................###
#...............................................#
#...............................................#
#################################################
