#################################################
#.....###.............T.....T...................#
#.....###........###..........................###
a......@....T....#.#....T.....................d##
#......h.........###........T.................###
#...............................................#
#...............................................#
#################################################
