#################################
#......#########................############################
a.@....#########................X...........X...............#
#####-##########................#############...............d
#####.##########................#############...............#
#####...........................#############...............#
#############################################################
