#################################################
#.....###.............T.....T...................#
#.....###........###..........................###
#......@....T....#.#....T.....................d##
#................###........T.................###
#...............................................#
#...............................................#
#################################################
