###################
#@.....#...........#
#......#...........#
#......|...........#
#......#...........#
#############-######
#############....<#
#>...............<#
#>...............<#
#>..........#######
#>..........#.....#
#>..........X.....#
###################
