#################################
#......#########................############################
a.@....#########................X...........X...............#
#####-##########................#############...............#
#####.##########................#############...............#
#####...........................#############...............#
#############################################################
