#################################################
#@.....#................#.......#...............#
#......#................#.......|...............#
#......|................|.......#...............#
#......#................#.......#...............#
#############-##################################
#############....<#.............#............#
#>...............<#.............#............#
#>...............<#.............X............#
#>..........#######.............#............#
#>..........#...................#............#
#>..........X...................#............#
##############################################
