#################################
#@.....#................#.......#
#......#................#.......#
#......|................|.......#
#......#................#.......#
#############-###################
#############....<#.............#
#>...............<#.............#
#>...............<#.............#
#>..........#######.............#
#>..........#...................#
#>..........X...................#
#################################
