#################
#.......#.......#
a@..............d
#...............#
#.......#.......#
#################
