#############################################
#.......#.......#############################
a.@.............d###########................#
#...........................................#
#.......#.......############................#
#############################################
