#############################################
#.......#.......#############################
#.@.............d###########................#
#...........................................#
#.......#.......############................#
#############################################
